EEEEEEEEEEEEEEEEEEEEEEEEEEEE
EEEEEEEEEEEEEEEEEEEEEEEEEEEE  
EEEEEEEEEEEEEEEEEEEEEEEEEEEE !
EECEEEECEEEEEEMEEEEEEECEEEEE
EMEEEEMEECEEEEEEEEEEEMEEECEE
EEEEEEEEEMEEEMEEMEECEEEMEEEE
EEEMEEMEEEESEEEEEEEEEEECEEEE
EECEEEEEMEEEEMEEECEEEEMEEEEE
EEEEMECEEECEEEECEEEMEEEESEEE
EECEEEEMEEEEEEMEEEEEEEEEEMEE
EMEECEENEEEMEEEEECEEMEEEEEEE
EEEMEEEECEEEEESEEEEEEEECEEEE
EEEEEEMEEEMEEEEMEECEEEEMEEEE
EEMEEEEEEEEEMEEEEMEEEMEEECEE
EEEEEEEEEEEEEEEEEEEEEEEEEEEE   !
EEEEEEEEEEEEEEEEEEEEEEEEEEEE  
EEEEEEEEEEEEEEEEEEEEEEEEEEEE  
EEEEEEEEEEEEEEEEEEEEEEEEEEEE     