EEEEEEEEEEEEEEEEEEEEEEEEEEEE
EEEEEEEEEEEEEEEEEEEEEEEEEEEE  
EEEEEEEEEEEEEEEEEEEEEEEEEEEE !
EEEEEEEEEEMEEEEEEEEEEEMEEEEE
EEEEEMEEEEEEMEEEMEEEEEEECEEE
EMEEMSEMEECEEMEEECEMEEEEMEEE
EEMEEECEMEEEEECEMEEEMEECEEME
EEECEMEEEEMEEECEEEEMEEESEEEE
EEMEEECEECEEMEMEEMEEEMEECMEE
EEMEEMEMEEEEMEECEEEECECEMEEE
ECEEEEEEMEECEESEMEENEMEEEMEE
EEEMEEECECEMEEEEECEMEEMEEEEE
EEEEEMEEECEEEEMEEEEECEEEMEEE
EEMEEEEMEEEMEEEEEECEMEMEMEEE
EEEEEEEEEEEEEEEEEEEEEEEEEEEE   !
EEEEEEEEEEEEEEEEEEEEEEEEEEEE  
EEEEEEEEEEEEEEEEEEEEEEEEEEEE  
EEEEEEEEEEEEEEEEEEEEEEEEEEEE     