EEEEEEEEEEEEEEEEEEEEEEEEEEEE
EEEEEEEEEEEEEEEEEEEEEEEEEEEE  
EEEEEEEEEEEEEEEEEEEEEEEEEEEE !
EEEEEEEEMEEEEEEEEEEMECEEEMEE
EMEMEEEMEECEEMEEECEMEEEEMCEE
EEMEEECEMEEEEEEEMEEEMEEESEME
EEECEMEEEEMEEECEECEMEEEEEMEE
EEMEEECEECEEMEEEEMEEEMEECMEE
EEMEEMEMETEEMEECMEEEEECEMEEE
ECESEEEEMEEEEEEEMEECEMEEEMEE
EEEEMEECEEMECEEEEMEMEEMEEEEE
EECEEEMEEEEEEEMECEEECEEEMEEE
EEEEMEECEEEMEEEEEESEMEMEMEEE
EEEEEEEEEEEEEEEEEEEEEEEEEEEE   !
EEEEEEEEEEEEEEEEEEEEEEEEEEEE  
EEEEEEEEEEEEEEEEEEEEEEEEEEEE  
EEEEEEEEEEEEEEEEEEEEEEEEEEEE 