EEEEEEEEEEEEEEEEEEEEEEEEEEEE
EEEEEEEEEEEEEEEEEEEEEEEEEEEE  
EEEEEEEEEEEEEEEEEEEEEEEEEEEE !
EEEEEEEEEEEEEEEEEEEEEEEEMEEE
EMEEEEEMEEEEMEEEEEEMEEEMEEEE
EEEMEECEEEEEEEEEMEEEEEEEEEEE
EEEEMEECEEEEEEMEEEEMEEEMEEEE
EEMEECEEEMEEECEEEECEEEEEEMEE
EECEESECEEEEMEEEEMEEEMEEEEEE
EEMEEMEEEEMEEEMEEEEEEEMEEMEE
EECEEEECEEECEEEEEEMEEEESEMEE
EEEEMEEEECEECEEEEEEEECECEEEE
EMEEEEMEESEEMEEMEEECEEEMEEEE
EEEECEEEEEEMEEMEECEEEEEEEEEE
EEEEEEEEEEEEEEEEEEEEEEEEEEEE   !
EEEEEEEEEEEEEEEEEEEEEEEEEEEE  
EEEEEEEEEEEEEEEEEEEEEEEEEEEE  
EEEEEEEEEEEEEEEEEEEEEEEEEEEE     