EEEEEEEEEEEEEEEEEEEEEEEEEEEE
EEEEEEEEEEEEEEEEEEEEEEEEEEEE  
EEEEEEEEEEEEEEEEEEEEEEEEEEEE !
EEEEMEMESEEEEEEEECECMEEEEMEE
EEMEECEEEMEEECEESEEEEECEMEEE
EECEMEEMEEEEMEEEMEEEMEEEEEEE
EEMEEMEECEMEEEMEEEEMEEECEMEE
EEEEEMECEEEEMEEEMCEEEMEEEMEE
EEMEEEEEMEEETECEEMEECEEEMEEE
EEEECESEEECMEEEEMECEEMEEEMEE
EEEEMECEEMEEEEEEEMEMEEMEEEEE
EEMEEEEMEEEECEMEEEEEEEEEMEEE
EEEEMEECEEEMEMEEMEMECEMEEEEE
EEEEEEEEEEEEEEEEEEEEEEEEEEEE   !
EEEEEEEEEEEEEEEEEEEEEEEEEEEE  
EEEEEEEEEEEEEEEEEEEEEEEEEEEE  
EEEEEEEEEEEEEEEEEEEEEEEEEEEE 