EEEEEEEEEEEEEEEEEEEEEEEEEEEE
EEEEEEEEEEEEEEEEEEEEEEEEEEEE  
EEEEEEEEEEEEEEEEEEEEEEEEEEEE !
EEEEEEEEEEEEEEEEEEEEEEEECEEE
EEEEEEEEEEESEEEEEEEEEEMEECEE
EECEEMECEEEEEEEEEEMEEEECMEEE
EEEMEMEEEEECEEMEEEEEEMEEEEME
EEMEECEEEMEEECEEMEMEEEEEEMEE
EECEEEECEEEEMEEEEMEEEMEEEEEE
EEMEEMEEEEMEEEMEEEEEEEMEEMEE
EECEEEECEEECEEEESEMEEEEEEMEE
EEEEMEEEEEEEEMEEEMEEEMECEEEE
EMEEEESEEMEEEEECEEECEEEMEEEE
EEEEEMEEEECEEMEEEEMEEEEECEEE
EEEEEEEEEEEEEEEEEEEEEEEEEEEE   !
EEEEEEEEEEEEEEEEEEEEEEEEEEEE  
EEEEEEEEEEEEEEEEEEEEEEEEEEEE  
EEEEEEEEEEEEEEEEEEEEEEEEEEEE     