EEEEEEEEEEEEEEEEEEEEEEEEEEEE
EEEEEEEEEEEEEEEEEEEEEEEEEEEE  
EEEEEEEEEEEEEEEEEEEEEEEEEEEE !
EEEEECEEEEMEEECEEEMEEMEEEEME
EEMEEEMECEEEEEEMEEEECEEMEEEE
ECEESEEEEEEMEECEEMEEMEEEEMEE
EEEMEMEEMEEEMEEEEECEESECEEEE
EMEEEEECEMEEEEMEEEEMEEEEMEEE
EEECEMEEEECEEMEEEEECEEEEEECE
EEESEEEEMEECEEECMEEMEEECEEEE
EMEEECEEEECEEEETEEENECEEEEEE
EECEEEMEEEEMEMEECEMEEEEMEEEE
EEEEEEEMEEMEEEEEEEEECEEEEMEE
EECEMEEEECEEECMEEMEEEMEMEEME
EEEEEEEEEEEEEEEEEEEEEEEEEEEE   !
EEEEEEEEEEEEEEEEEEEEEEEEEEEE  
EEEEEEEEEEEEEEEEEEEEEEEEEEEE  
EEEEEEEEEEEEEEEEEEEEEEEEEEEE     